#
# Source:  
# Date:    
# Level:   
#
9,.,., .,.,., 8,.,.
.,.,8, 9,.,7, .,.,.
2,4,., .,8,., .,.,.
#
.,.,9, .,7,., 2,.,.
.,.,., 6,.,., .,1,.
.,3,., .,.,., .,.,6
#
.,.,4, .,2,., 9,.,.
5,.,., .,.,., .,3,.
.,.,., .,.,1, .,.,5
